####################################################################################################
##......####......[][][]..##..[]..[][][]............[]######......[]..##....[]..............[]....##
##........[]......[]..........[]....[]##[]##[]..[]........[]......[][]##[][][][]........[][][]....##
##....[]..[]....[]..##....##......[]......[]..[]........##........[]....[][]..##[]##....[]........##
##....................[][]........[]....##[][]......[]..[]..[]........##....[]..............##..####
##[][]..............[]..........[][]..........[]..........[]..[]..##......[]....[]....[]##..##....##
##........##....[]..##..........[][][]..[]............[]........[][]..[]##[][]..[]......[]..##..[]##
##..[]##..[][]........[]##......[][]......[]..[]....................[]..................[][]....[]##
##[][]..[]##..[]......[]..[]....[]..........[]##[]..[]....[]......[][][]......[]........##[][][][]##
##....[][]..[]................[]....##........[][][][][]....[][]......[]##....[][]####........[][]##
##........[]..[]......##..[]........[][]......##....##......[]......[]......[]..##....[]..[]......##
####..........[][]##[]....[]..........[]####..[][][]........[][]....[][][][]..[]................[]##
##..##..##....[]......##..[][][]..[]..............[]..[][]..[]......[]##........[][]........##[][]##
##....####..[]..##....##....[]....[]......[][][]......[]....[]..[][][][]......[]..[][]..##......[]##
##........[]....[]##..[]..[][]..[]..................[]..[]..[]..[][]##..[]..##[]##....[][]##..[]..##
##..........[]..........................##......[]....[]....[]##..[]..[][]....[]..[][]....[]......##
##..##....[]....##[]......[]........##....[]..##..........[]..........[]..................[]......##
##....[]....[]....[]##[]..........[]........##..[]......##[][]........[]..........##..............##
##[]....[]##............[][]......[][]..[]....[]##[][][][]................[]..[][][]....[]....[][]##
##[][]......[]..##......[]##[]....##..[]..##..##........[]..[][]........[][]..[]....[]..[]....[]..##
##..##......##..[]....[]....[]..............##..................##..[]..[]..........[]....[]......##
##[]..[]....[]......[]......[]....[]..[]..[]..##....##[]....[][][]........[]........##....##......##
##......[][]##[]............[]..[]....[][][][]##..[]##................[][]....##[]..##[][]......[]##
##[]##........[][]......[]##....[][]..##..[][]........[]......[][]........##....[]......[]..[]....##
####......##................##....[]........[]##@.[]##[]................[]..[][]....[]##..[]..[]..##
##[][]..##........[][]..[]......[][]......[][]....[]........[]..[]..[]......[]##......[]..[][]....##
##..[][]##....##....##[]..[]##....[][]..##[]..[]##..[][]....[][]..##....[]............##..........##
##..##....[]..[]....##[]....[]........[]........##......[][]............[]............[]##....[]..##
##[]......##..[]##........[][]........[]......[]..##..............##[]........[]..[]##..[]........##
##........##..[]......[]......[]................[][]..##..[]....[]............##....##....##..[]..##
##....[][]........[]....[]..##................[]....##............[]....[]........##[][]......##..##
##....[][]..[][]##......##....##..........##....[]##..##[]....[]..[]......[]..[]....[]..[]........##
##[]..[][]........[]....[][]..##....[][][]....[][]####........##..[]......[][][]......##........[]##
##..[][][]##....##................[]......[]..[]..##..............[][]....[]..[]............[]..[]##
##..............[][]....[]..[]................[]......[][]..........[]..........##..[]..[][][]##..##
##[][]..............[][][][]..........[]........[]..........##..##......[][]................[]..[]##
##....[]..[][][][]......[]....[]..[]##..[][]..[][]..##......[][]##..[][]............[]....[]..[]..##
##..[]..[]..##..[]##....[]..[]..[]......##[]......[]......[]......[]..[]..[]......[]..##[]##[]....##
##[][]##................[]................[][]....[]##[]..............[]....##......[]............##
##..##..##....[][]..[][]....[]........##[][]........[]..[][]......[]##..##........##..............##
####..##..[]##[]....[][]..[]............[]....[]##..............##[][]##..............[]..[][]....##
##..........[]....[]......[]......##[][][]..[]..[]......[]......[]....[]....##......[]......##..[]##
##[]..####[]........##..[]......[]..[][]..............[]..........[]....[]..[]....[]........[]....##
##..[]......[]..[]....##[]..##..........[]....[][]..........##[]........[]..[]....[]....[]..[]..[]##
##........##[]....[][]..[][]##..[][]......[]......##..[][]##......[][]........[]..[]..............##
##..[]....[]........##[][][]....[]............####....##[]..[]..............[]......##[]....[]....##
####[]....[]......[]..[]..............[]##..............##..[]##..[]..[]..[]##....[]......[]..[]..##
##[]..##......[]..[]........##..##..........[]..........[][]..##..[]..##......##..........[][]....##
##..[]..[][]..[]................##......##..............[][]##........##....[]##..[]..............##
####################################################################################################
